T;T;T;T;T;T;T;T;T;T;T;T;T;T;T;T;T;T;T;T;
T;T;T;T;T;T;T;T;T;T;T;T;T;T;T;T;T;T;T;T;
T;T;T;T;T;T;T;T;T;T;T;T;T;P;T;T;T;T;T;T;
T;T;T;T;T;T;T;T;T;T;T;T;P;F;P;T;T;T;T;T;
T;T;T;T;T;T;T;T;T;T;T;P;F;P;F;P;T;T;T;T;
T;T;T;T;T;T;T;T;T;T;P;F;P;F;P;F;P;T;T;P;
T;T;T;T;T;T;T;T;T;P;F;P;F;P;F;P;F;P;P;F;
T;T;T;T;T;T;T;T;P;F;P;F;P;F;P;F;P;F;F;P;
P;P;P;P;P;P;P;P;F;P;F;P;F;F;F;P;F;P;P;F;
P1;G;G;G;G;G;G;G;G;G;G;G;G;M8;G;G;G;G;G;BEL;
S;G;G;G;G;G;G;F;F;F;F;F;F;F;F;F;F;F;F;F;
P;P;P;P;P;P;P;P;F;P;F;P;F;F;F;P;F;P;P;F;
T;T;T;T;T;T;T;T;P;F;P;F;P;F;P;F;P;F;F;P;
T;T;T;T;T;T;T;T;T;P;F;P;F;P;F;P;F;P;P;F;
T;T;T;T;T;T;T;T;T;T;P;F;P;F;P;F;P;T;T;P;
T;T;T;T;T;T;T;T;T;T;T;P;F;P;F;P;T;T;T;T;
T;T;T;T;T;T;T;T;T;T;T;T;P;F;P;T;T;T;T;T;
T;T;T;T;T;T;T;T;T;T;T;T;T;P;T;T;T;T;T;T;
T;T;T;T;T;T;T;T;T;T;T;T;T;T;T;T;T;T;T;T;
T;T;T;T;T;T;T;T;T;T;T;T;T;T;T;T;T;T;T;T;
