A;A;A;A;A;A;A;A;A;A;A;A;A;A;A;A;A;A;A;A;
A;T;T;T;T;T;T;T;T;T;T;T;T;T;T;T;T;T;T;A;
A;T;G;G;P;G;G;G;P;G;G;G;P;G;G;G;P;G;T;A;
A;T;G;P;P;P;G;P;P;P;G;P;P;P;G;P;P;P;T;A;
A;T;G;P;JO;P;G;P;SV;P;G;P;INI;P;G;P;T;P;T;A;
A;T;P1;G;G;G;G;G;G;G;G;G;G;G;G;G;G;G;T;A;
A;T;G;P;G;G;G;P;G;G;G;P;G;G;G;P;G;G;T;A;
A;T;P;P;P;G;P;P;P;G;P;P;P;G;P;P;P;G;T;A;
A;T;P;LE;P;G;P;LI;P;G;P;T;P;G;P;T;P;G;T;A;
A;T;G;G;G;G;G;G;G;G;G;G;G;G;G;G;G;G;T;A;
A;T;G;G;P;G;G;G;P;G;G;G;P;G;G;G;P;G;T;A;
A;T;G;P;P;P;G;P;P;P;G;P;P;P;G;P;P;P;T;A;
A;T;G;P;T;P;G;P;T;P;G;P;T;P;G;P;T;P;T;A;
A;T;G;G;G;G;G;G;G;G;G;G;G;G;G;G;G;G;T;A;
A;T;G;P;G;G;G;P;G;G;G;P;G;G;G;P;G;G;T;A;
A;T;P;P;P;G;P;P;P;G;P;P;P;G;P;P;P;G;T;A;
A;T;P;T;P;G;P;T;P;G;P;T;P;G;P;T;P;G;T;A;
A;T;G;G;G;G;G;G;G;G;G;G;G;G;G;G;G;G;T;A;
A;T;T;T;T;T;T;T;T;T;T;T;T;T;T;T;T;T;T;A;
A;A;A;A;A;A;A;A;A;A;A;A;A;A;A;A;A;A;A;A;
