P;P;P;P;P;P;P;P;P;P;P;P;P;P;P;P;P;P;P;P;
P;T;T;T;T;T;T;T;T;T;T;T;T;T;T;T;T;T;T;P;
P;T;A;A;A;A;A;A;A;A;A;A;A;A;A;A;A;A;T;P;
P;T;A;F;F;F;F;F;F;F;F;F;F;F;F;F;F;A;T;P;
P;T;A;F;V;V;V;V;V;V;V;V;V;V;V;V;F;A;T;P;
P;T;A;F;V;G;G;P;G;G;G;G;P;G;G;V;F;A;T;P;
P;T;A;F;V;G;P;P;P;G;G;P;P;P;G;V;F;A;T;P;
P;T;A;F;V;G;P;NV;P;G;G;P;CA;P;G;V;F;A;T;P;
P;T;A;F;V;G;G;P1;G;G;G;G;G;G;G;V;F;A;T;P;
P;T;A;F;V;G;G;G;G;G;G;G;G;G;G;V;F;A;T;P;
P;T;A;F;V;G;G;G;G;G;G;G;G;G;G;V;F;A;T;P;
P;T;A;F;V;G;G;P;G;G;G;G;P;G;G;V;F;A;T;P;
P;T;A;F;V;G;P;P;P;G;G;P;P;P;G;V;F;A;T;P;
P;T;A;F;V;G;P;CR;P;G;G;P;SA;P;G;V;F;A;T;P;
P;T;A;F;V;G;G;G;G;G;G;G;G;G;G;V;F;A;T;P;
P;T;A;F;V;V;V;V;V;V;V;V;V;V;V;V;F;A;T;P;
P;T;A;F;F;F;F;F;F;F;F;F;F;F;F;F;F;A;T;P;
P;T;A;A;A;A;A;A;A;A;A;A;A;A;A;A;A;A;T;P;
P;T;T;T;T;T;T;T;T;T;T;T;T;T;T;T;T;T;T;P;
P;P;P;P;P;P;P;P;P;P;P;P;P;P;P;P;P;P;P;P;
